coolTiles.png 
15   
0 32 16 16  
16 32 16 16  
32 32 16 16  
0 48 16 16  
16 48 16 16  
32 48 16 16
0 64 16 16 
16 64 16 16
32 64 16 16
80 16 16 16
0 96 16 16
48 32 16 16
64 32 16 16
48 48 16 16
64 48 16 16

30 20 
0 1 1 1 1 1 1 1 1 1 1 1 1 1 1 1 1 1 1 12 10 10 10 10 10 10 10 10 10 10
3 9 9 9 9 9 9 9 9 9 9 9 9 9 9 9 9 9 9 3 10 10 10 10 10 10 10 10 10 10
3 9 9 9 9 9 9 9 9 9 9 9 9 9 9 9 9 9 9 3 10 10 10 10 10 10 10 10 10 10
3 9 9 9 9 9 9 9 9 9 9 9 9 9 9 9 9 9 9 3 10 10 10 10 10 10 10 10 10 10
3 9 9 9 9 9 9 9 9 9 9 9 9 9 9 9 9 9 9 3 10 10 10 10 10 10 10 10 10 10
3 9 9 9 9 9 9 9 9 9 9 9 9 9 9 9 9 9 9 3 10 10 10 10 10 10 10 10 10 10
3 9 9 9 9 9 9 9 9 9 9 9 9 9 9 9 9 9 9 3 10 10 10 10 10 10 10 10 10 10
3 9 9 9 9 9 9 9 9 9 9 9 9 9 9 9 9 9 9 3 10 10 10 10 10 10 10 10 10 10
3 9 9 9 9 9 9 9 9 9 9 9 9 9 9 9 9 9 9 3 10 10 10 10 10 10 10 10 10 10
3 9 9 9 9 9 9 9 9 9 9 9 9 9 9 9 9 9 9 3 10 10 10 10 10 10 10 10 10 10
3 9 9 9 9 9 9 9 9 9 9 9 9 9 9 9 9 9 9 3 10 10 10 10 10 10 10 10 10 10
3 9 9 9 9 9 9 9 9 9 9 9 9 9 9 9 9 9 9 6 1 1 1 1 1 1 1 1 1 2
3 9 9 9 9 9 9 9 9 9 9 9 9 9 9 9 9 9 9 9 9 9 9 9 9 9 9 9 9 5
3 9 9 9 9 9 9 9 9 9 9 9 9 9 9 9 9 9 9 9 9 9 9 9 9 9 9 9 9 5
3 9 9 9 9 9 9 9 9 9 9 9 9 9 9 9 9 9 9 9 9 9 9 9 9 9 9 9 9 5
3 9 9 9 9 9 9 9 9 9 9 9 9 9 9 9 9 9 9 9 9 9 9 9 9 9 9 9 9 5
3 9 9 9 9 9 9 9 9 9 9 9 9 9 9 9 9 9 9 9 9 9 9 9 9 9 9 9 9 5
3 9 9 9 9 9 9 9 9 9 9 9 9 9 9 9 9 9 9 9 9 9 9 9 9 9 9 9 9 5
3 9 9 9 9 9 9 9 9 9 9 9 9 9 9 9 9 9 9 9 9 9 9 9 9 9 9 9 9 5
6 1 1 1 1 1 1 1 1 7 7 1 1 1 1 1 1 1 1 1 1 1 1 1 1 1 1 1 1 8